5 0 0 0 0 0 0 0 0 0 0 0 0 0 0 0 0 0 0 0 0 0 0 0 0 0 0 0 0 0 0 0
5 4 4 4 4 4 4 4 4 4 4 4 4 4 0 0 0 0 0 0 0 0 0 0 0 0 0 0 0 0 0 0
3 0 0 0 0 0 0 0 3 0 0 0 0 0 1 0 6 0 1 0 0 0 0 0 3 0 0 0 0 0 0 0
3 0 0 0 0 0 0 3 3 3 0 0 0 0 1 1 1 1 1 0 0 0 0 3 3 3 0 0 0 0 0 0
3 0 0 0 6 0 0 0 3 0 0 0 6 0 0 0 0 0 0 0 6 0 0 0 3 0 0 0 6 0 0 0
3 0 0 0 3 3 0 0 3 0 0 3 3 0 0 0 0 0 0 0 3 3 0 0 3 0 0 3 3 0 0 0
3 0 0 0 3 0 3 3 3 3 3 0 3 0 0 0 0 0 0 0 3 0 3 3 3 3 3 0 3 0 0 0
3 0 0 0 3 0 3 3 3 3 3 0 3 0 0 0 3 0 0 0 3 0 3 3 3 3 3 0 3 0 0 0
3 0 0 0 3 0 0 6 8 6 0 0 3 0 0 3 3 3 0 0 3 0 0 6 8 0 0 3 0 0 0 0
3 0 0 0 0 3 1 1 1 1 1 3 0 0 0 0 3 0 0 0 0 3 1 1 1 1 1 3 0 0 0 0
3 0 0 0 0 0 3 3 3 3 3 0 3 3 0 0 3 0 0 3 3 0 3 3 3 3 3 0 0 0 0 0
3 0 0 0 0 0 0 0 0 0 0 0 3 0 3 3 3 3 3 0 3 0 0 0 0 0 0 0 0 0 0 0
3 0 0 0 0 0 0 0 0 0 0 0 3 0 3 3 3 3 3 0 3 0 0 0 0 0 0 0 0 0 0 0
3 0 0 0 0 0 0 0 0 0 0 0 3 0 3 3 3 3 3 0 3 0 0 0 0 0 0 0 0 0 0 0
3 0 0 0 0 0 0 0 0 0 0 0 3 0 0 6 8 6 0 0 3 0 0 0 0 0 0 0 0 0 0 0
3 0 0 0 0 0 6 0 0 0 0 0 0 3 1 1 1 1 1 3 0 0 0 0 0 0 6 0 0 0 0 0
3 1 1 1 1 1 1 1 3 0 0 0 0 0 3 3 3 3 3 0 0 0 0 0 3 1 1 1 1 1 1 1
3 0 0 0 0 0 0 0 3 0 0 0 0 0 0 0 0 0 0 0 0 0 0 0 3 0 0 0 0 0 0 0
3 0 0 0 0 0 0 0 3 0 0 0 0 0 0 0 0 0 0 0 0 0 0 0 3 0 0 0 0 0 0 0
3 0 0 0 0 0 0 0 3 0 0 0 0 0 0 0 0 0 0 0 0 0 0 0 3 0 0 0 0 0 0 0
3 0 0 0 0 0 0 0 3 0 0 0 0 0 0 0 0 0 0 0 0 7 0 0 3 0 0 0 0 0 0 0
1 1 1 1 1 1 1 1 1 1 1 1 1 1 1 1 1 1 1 1 1 1 1 1 1 1 1 1 1 1 1 1
