0 4 3 3 3 1 0 0 0 0 0 1 0 0 0 0 0 1 1 0 0 1
0 4 0 0 0 1 0 0 0 0 0 1 0 0 0 0 0 1 1 0 0 1
0 4 0 0 6 1 0 0 0 0 0 1 0 0 0 0 0 1 1 0 0 1
0 4 0 0 0 1 0 0 0 0 6 1 0 0 0 0 0 1 1 0 0 1
0 4 0 0 0 1 0 0 0 0 0 1 0 0 0 0 0 3 3 3 3 1
0 4 0 0 0 1 0 0 0 0 0 3 3 3 3 3 3 1 1 0 0 1
0 4 0 0 0 3 3 3 3 3 3 1 0 4 0 0 0 1 1 0 0 1
0 4 0 0 0 0 0 1 0 0 0 0 0 4 0 0 0 1 1 0 0 1
0 4 0 0 0 0 0 1 0 0 0 0 0 4 0 0 0 1 1 0 0 1
0 4 0 0 0 0 8 1 0 0 0 0 0 4 0 0 0 1 1 0 0 1
0 4 0 0 0 0 0 1 0 0 0 3 3 3 0 0 0 1 1 0 0 1
0 4 3 3 3 3 3 1 0 0 0 1 0 0 0 0 0 1 1 0 0 1
0 0 1 0 0 0 0 1 0 0 0 1 0 0 0 0 0 1 1 0 0 1
0 0 1 0 0 0 0 3 3 3 3 1 0 0 3 3 3 1 1 0 7 1
0 0 1 0 0 0 0 1 0 0 0 1 0 0 1 1 1 1 1 0 0 1
0 0 1 0 0 0 0 1 0 0 0 1 0 0 1 1 1 0 0 0 0 1
0 0 1 0 0 0 0 1 0 0 0 1 0 0 1 1 1 0 3 3 3 1
0 6 1 0 0 0 0 1 0 0 8 1 0 0 1 1 1 0 1 1 1 1
0 0 1 0 0 0 0 1 0 0 0 3 3 3 1 1 1 0 1 1 1 1
0 0 1 0 0 0 6 1 0 0 0 1 0 0 1 1 1 0 1 1 1 1
0 0 1 0 0 0 0 1 0 0 0 1 0 0 1 1 1 6 1 1 1 1
0 0 1 0 0 0 0 3 3 3 3 1 0 8 1 1 1 0 3 3 3 1
0 0 1 0 0 0 0 1 0 0 0 0 0 0 1 1 1 0 0 0 0 1
0 0 1 0 0 0 0 1 0 0 0 0 0 0 1 1 1 1 1 0 0 1
0 0 1 0 0 0 0 1 0 0 0 0 0 0 3 3 3 1 1 0 0 1
0 0 3 3 3 3 3 1 0 0 0 0 0 0 0 0 0 1 1 0 0 1
0 0 0 0 2 0 0 0 4 0 0 0 0 0 0 0 0 1 1 0 6 1
0 0 0 0 2 0 0 0 4 0 0 0 0 0 0 0 0 1 1 0 0 1
0 0 0 0 2 0 0 0 0 4 0 0 0 0 0 0 0 1 1 0 0 1
0 0 0 0 2 0 0 0 0 4 0 0 0 0 0 0 0 1 1 0 0 1
0 0 0 0 2 0 0 0 0 0 4 0 0 0 0 0 0 3 3 3 3 1
5 5 5 5 2 0 0 0 0 0 4 0 6 1 0 0 0 1 1 0 0 1