50000000000000000000000000000000
54444444444444000000000000000000
30000000300000106010000030000000
30000003330000111110000333000000
30006000300060000000600030006000
30003300300330000000330030033000
30003033333030000000303333303000
30003033333030003000303333303000
30003006860030033300300680030000
30000311111300003000031111130000
30000033333033003003303333300000
30000000000030333330300000000000
30000000000030333330300000000000
30000000000030333330300000000000
30000000000030068600300000000000
30000060000003111113000000600000
31111111300000333330000031111111
30000000300000000000000030000000
30000000300000000000000030000000
30000000300000000000000030000000
30000000300000000000070030000000
11111111111111111111111111111111
