00000000000050000000000000000000
00000000000050000000600000008000
11111100000050000001111311111111
00001110000050000011100300000000
00000111000050000111000300000000
00000011100050001110000300000000
68000011110050011110000300006000
11131111111050111113111111111111
00030000111131111003000000000000
00030000000030000003000000000000
00030000009030000003000000000000
00036000000030000003000806000000
31111300000030000011113111000000
30000300000030000000003000000000
30000300000000000000003000000000
30000300000000000000003000000000
30000300000060000008003000000000
30000311111111311111111111113111
30000000000000300000000000003000
30000000000000300000000000003000
30000000000000300070000000003000
11111111111111111111111111111111