0 3 3 3 3 3 3 3 3 3 3 3 3 2 2 2 2 1 0 0 0 1
0 2 0 0 0 1 0 0 0 0 0 0 0 2 1 0 6 1 0 0 0 1
0 2 0 0 6 2 0 0 0 0 0 0 0 1 1 0 0 1 0 0 0 1
6 1 0 0 0 1 0 0 0 0 0 0 0 1 1 0 0 1 0 0 0 1
0 2 0 0 8 2 0 0 0 0 0 0 8 1 2 2 2 1 0 0 0 1
0 2 0 0 0 1 0 0 0 0 0 0 0 2 2 2 2 1 0 0 0 1
0 3 3 3 3 3 3 3 3 3 3 3 3 1 0 0 0 1 0 0 0 1
0 0 0 0 0 0 4 0 4 0 0 0 0 2 0 0 0 1 0 0 0 1
0 0 0 0 0 0 4 0 4 0 0 0 6 2 0 0 0 1 0 0 0 1
0 0 0 0 0 0 4 0 4 0 0 0 0 1 0 0 0 3 3 3 3 1
0 0 0 0 0 0 0 0 4 0 0 0 0 1 0 0 0 1 0 0 0 1
0 0 0 0 0 0 0 0 4 0 0 0 0 2 0 0 0 1 0 0 0 1
0 0 0 0 0 0 0 0 4 0 0 0 0 2 0 0 0 1 0 0 0 1
0 0 0 3 3 3 3 3 3 3 3 3 3 3 3 3 3 1 0 0 0 1
0 0 0 1 0 0 0 0 0 0 0 0 1 0 0 0 0 2 0 0 0 1
0 0 0 1 0 0 0 0 0 0 0 0 1 0 0 0 0 2 0 0 0 1
0 0 0 1 0 0 0 0 0 0 0 6 1 0 0 0 0 2 0 0 7 1
0 0 0 1 0 0 0 0 0 0 0 0 1 0 0 0 4 2 0 0 0 1
0 0 0 1 0 0 0 0 0 0 0 0 1 0 0 0 4 0 0 0 0 1
0 0 0 1 0 0 0 0 0 0 0 0 1 0 0 0 4 0 0 0 0 1
0 0 0 1 0 0 0 0 0 3 3 3 3 0 0 0 4 0 0 0 0 1
0 0 0 1 0 0 0 0 0 1 0 0 0 0 0 0 4 0 0 0 0 1
0 0 6 1 0 0 0 0 0 1 0 0 0 0 0 0 4 0 0 0 0 1
0 0 0 1 0 0 0 0 0 1 0 0 0 0 0 0 4 0 0 0 0 1
0 0 0 1 0 0 0 0 0 1 0 0 0 0 3 3 3 3 3 3 3 1
0 0 0 3 3 3 3 3 3 2 0 0 0 0 1 0 0 0 0 0 0 1
0 0 0 0 0 1 0 0 0 2 0 0 0 0 1 0 0 0 0 0 0 1
0 0 0 0 6 1 0 0 0 2 0 0 0 0 1 0 0 0 0 0 0 1
0 0 0 0 0 1 0 0 0 2 0 0 0 0 1 0 0 1 0 0 0 1
0 0 0 0 0 1 0 0 0 2 0 0 0 0 3 3 3 1 0 0 0 1
0 0 0 0 0 9 0 0 0 2 0 0 0 0 1 0 0 1 0 0 0 1
3 3 3 3 3 3 3 3 3 3 3 3 3 3 1 0 6 1 0 0 0 1
